3#3
0#   #0#0
2#FrA#0#1
6#TrA#0#2
0#   #1#0
0#   #1#1
3#FrA#1#2
0#   #2#0
5#TrA#2#1
4#PrA#2#2
